$answer: 2, 2, %car
$answer: 4, 2, %fish
1111111111
1        1
1 ҹ ҹ Ć  1
1     2  1
1     1  1
1        1
1        1
13       1
1        1
1111111111