$hint: Push the top white ball all the way down.
$stonepattern: 1
11111111111111111111111111111111
1            3                 1
1 4   2                        1
111111111111111       1111111111
111111111111111       1111111111
1       J111111       1111111111
1                          3   1
1                              1
1    111111111111111111111111111
1    111111111111111111111111111
1    1111111111I            3  1
1    111111111I                1
1    11111111I       11111111111
1    1111111I       111111111111
1    111111I       1111111111111
1       3         11111111111111
1            4   111111111111111
1    111111111111111111111111111
1    111111111111111111111111111
11111111111111111111111111111111
