$hint: Push the top white ball all the way down.
11111111111111111111111111111111
1            3                 1
1 4   2                        1
111111111111111       1111111111
111111111111111       1111111111
1        111111       1111111111
1                          3   1
1                              1
1    111111111111111111111111111
1    111111111111111111111111111
1    1111111111             3  1
1    111111111                 1
1    11111111        11111111111
1    1111111        111111111111
1    111111        1111111111111
1       3         11111111111111
1            4   111111111111111
1    111111111111111111111111111
1    111111111111111111111111111
11111111111111111111111111111111
