$hint: Push all white balls down.
11111111111111111111111111111111
1                              1
1                              1
1   2                          1
1 1 1 1 4             1 1 1 1  1
1 1111111             1111111  1
1  11111               11111   1
1  11 11               11111   1
1  11111               11411   1
1  11118               11311   1
1  11111 1 1 1 4 4 1 1     4   1
1  111111111111111 111111111   1
1  111111111111111  11111111   1
1  1111111111111111  1111111   1
1  111111111     111  111311   1
1  111111111     1111          1
1  1111111113    11111111111   1
1      3                       1
1  8                           1
11111111111111111111111111111111
