$hint: Use the stacked white balls to cover almost the entire bottom.
$stonepattern: 1
11111111111111111111111111111111
1                       3      1
1                           4  1
1               1111111111111111
1              11111111111111111
1            4            111111
1          11111          111111
1           4             111111
1       11111111111        11111
1      11   44    1         1111
1 4   11    44    1          3 1
11111       44    1            1
1   11    4 44    1         1111
1      1111144           1111111
1     11    44      111111111111
1 4  11     44                31
1111        44                 1
1 3         44           4 4   1
1     2     44          11111111
11111111111111111111111111111111
