$stonepattern: 1
11111111111111111111111111111111
1     4   4                 8  1
1 111111111                 1111
1              11111111111     1
1          111111     311111   1
1 118                  11   U  1
1 111111111       4    11      1
1 111111111     111111111      1
1 111111111                    1
1 111311111     1111111111111111
1 1             1111111111111111
1 1 1111       U      3    11111
1 1 1111         44        11111
1 1 11111111111 111 111111111311
1U1         311                1
1 1  4    4  44                1
1 111111 111111 1111111 11111111
1                              1
1    2                     4   1
11111111111111111111111111111111
