$stonepattern: 1
11111111111111111111111111111111
1                            3 1
1  42                          1
111111         L    111111111111
11111                       1111
1111        111111             1
11          113111 1111111111111
11                           4 1
111         111111111111 111 111
1111          1111111111 111  11
1111           1111111111111   1
1118       U         111  31   1
1111      111   1111 11    1   1
111      11111   11     44 1   1
1       1111131      1111111   1
1                   U          1
1                    4    111111
1      1111111111 11111111111311
1                              1
11111111111111111111111111111111
