$stonepattern: 1
11111111111111111111111111111111
13                       4     1
1     5     5      11111111111 1
11111111111111111     3        1
111          5 4         4  4  1
1 3        111111   1111111111 1
1    5        5      3       1 1
1      42               4    1 1
1 111 111111111111      4      1
1 1111111111111111111111111111 1
1  3      11111111111111111111 1
1          1111111111111111111 1
1 11111111  111111111111111111 1
1 111111111          111111111 1
1 1111111111         111111111 1
1             4  4             1
1 1111111111111111111111111111 1
1 1111111111111111111  3  1111 1
1                         1111 1
11111111111111111111111111111111
