$stonepattern: 1
11111111111111111111111111111111
1        3  4                  1
1           4     4  111111111 1
1 111 11111111111111111        1
1 1                       4    1
1 11111111 111111111111111111  1
1    4 811        3           U1
1 11141111                     1
1 1  4      11111111111111111111
1 11111111U                    1
1                              1
1          D                   1
1 111111   111111111111        1
1   3                          1
1     11                4      1
1 111111  11          1111     1
1               5              1
1               5              1
1     2         5              1
11111111111111111111111111111111
