$stonepattern: 1
11111111111111111111111111111111
1         3  4     3           1
1      5     4    5    44     81
1    1111111 4111111 111111  111
1 4        1 4               3 1
11111111   1 4                 1
13    4    1 4      5  5       1
1   11111111 4   1111111111    1
1 4        1 4   1             1
11111111   1 4 111             1
1     4    1 4 1 3    11111    1
1   11111111 4 1         31    1
1 4        1 4 111     4  1    1
11111111   1 4   11   11111    1
1        4 1 4   1    5        1
1   11111111 4   1   5         1
1 4          4   1111111111    1
111111       4                 1
1      2     4                 1
11111111111111111111111111111111
