$stonepattern: 1
11111111111111111111111111111111
1       44                  4  1
1      11111    R        11111 1
1      3  5                    1
1            5                 1
1 111111111111111111111111111  1
1                              1
1 1111111111 1111111111111111111
1    3                   8     1
1                1111111111111 1
1 1111111111111111111311111111 1
1U      4            4     8   1
1 111111311111111111114   1111 1
1                     4        1
1 1  1111111111111111111111111 1
111111    3      3  3         U1
111                            1
11  11R           L       L  111
12 111                        81
11111111111111111111111111111111
