$stonepattern: 1
11111111111111111111111111111111
1           3               1111
1                4          1111
1        11111111111111111  1111
1       113      118        1111
11111  11        111111111  1111
1     11   1         55 3   1111
1  1111    1         55        1
1  111111111              4    1
1  11111111      11111111111   1
1  55                 11111    1
1 D55                 1111     1
1  55                 1111     1
1  55                 113      1
1  55                 11    U  1
1  55                 1111111111
1  11                          1
1  11                          1
12 11                          1
11111111111111111111111111111111
