$stonepattern: 1
11111111111111111111111111111111
1              11       13     1
11111          11 4     1      1
1          111 1111     111111 1
1            1 11              1
1            1 11            1 1
1            1 11            1 1
1         U  1 11            1 1
1  11U       1 1             1 1
1  31  11    1   55  111111 11 1
1  55   11   111111       1 11 1
1 D5  1  1     11         1 11 1
1        11    11  U      1 11 1
1      4       1111 1     1 11 1
1     111      111111     1   U1
1    11111     118             1
1              1111111    111111
1              11              1
12             11              1
11111111111111111111111111111111
