$stonepattern: 1
11111111111111111111111111111111
13               4          1111
1                4    4 4   1111
11 11111111 5 111111111111  1111
11        1 5    118        1111
11  1     1 1    1111111111 1111
13        1 1           3   1111
1   111   1 1                  1
1  11   11111       4          1
1   1 11111       1111111111   1
1  55        U        11111    1
1 U55    11111        1111     1
1  55                 1111     1
1  55                 113      1
1   1                 11       1
1  21                 1111111111
1 811                          1
1 811                          1
1 111                          1
11111111111111111111111111111111
