$stonepattern: 1
11111111111111111111111111111111
11  4         111              1
18 11111      111              1
11      45    111              1
13 111  111    3               1
1    3      5 5                1
1           11111   4 11       1
1    2  9         4111111      1
1 11111111111111114111113  5   1
1                 4        5   1
111111191111111111111 1111111111
1111111 111111111111111111111111
1111111 111118                31
13      111111                 1
1       9           111      111
1                 9          111
11111111111111111111111111111111
11111111111111111111111111111111
11111111111111111111111111111111
11111111111111111111111111111111
