$stonepattern: 1
11111111111111111111111111111111
111311111111               45  1
1         11 1111111111111 111 1
1        4        1111111111   1
1 1111111111      9 1   31     1
1                 9 1    1     1
1                 9    4 1     1
1                 9 111111     1
1                 9 1          1
1           999999  1          1
1   2              U1          1
1 1111111111 R    111          1
1          1      811          1
1          1111111111         U1
1                   3     111111
1                4             1
1   4          11111111111     1
1 111111111111113           5  1
1                           5  1
11111111111111111111111111111111
