$stonepattern: 1
11111111111111111111111111111111
1 3                            1
1       5                      1
11111111 11111111              1
11111         111111           1
1 3              111111 41111111
1        4       5      4      1
1     5  4              4      1
1        4              4      1
1 1111111111  11111  11111111  1
1           5       5          1
1            5     5           1
1             5   5            1
1              5 5             1
1               5              1
1              5 5             1
1             5   5            1
1            5     5           1
1  2        5       5          1
11111111111111111111111111111111
