11111111111111111111111111111111111111111111111111111111111111111111111111
1      3             3        3 4                     3      11113       1
1 2                             4                             111  5     1
1111111                 R   111111111                 9        1111 1111U1
11111                        1111111    R          1111111 4    11   11  1
1                             11111                 111111111   11   11  1
1           4                 1118                   111   11   11   11  1
1        111111111111         1111                    1         11    1  1
1         1111111111       11111                      18        11    1  1
1           1118          111111                      1111      11    1  1
1            1111     5  1111111                                11    1  1
1             1111    5       11     1 1 1 1                    11    1  1
1              3              11    11 111 11                   1     1  1
11111                    5     111111       11                  1     1  1
1111         111                  3          11                 3     11 1
111        1111                               11                      11 1
13       111111            11111111111         118              4    11  1
1    4   11111111        5         111 111      111           111111111  1
1 4 1111 111111111                     1111                              1
11111111111111111111111111111111111111111111111111111111111111111111111111
