$stonepattern: 1
11111111111111111111111111111111
1       <   2     >       >    1
11 11111111111111111111111111 11
1     <                  <     1
11111111 111111111111111111111 1
1         <        <    <      1
111111111111 1111111111111111111
1             >                1
1 111111111111111 11111111111111
1                   >      <   1
1 1111111 11111111111111111111 1
1 >   1                        1
11111 11 11111111 11111111111111
1        >  1       >       <  1
11111111111 11 111111111111111 1
1           <    >         >   1
11111 11111111111111111111111 11
1 3   11              3        1
1     <                        1
11111111111111111111111111111111
