11111111111111111111111111111111
1  3  <                        1
1    11     4            4 4   1
1   11    1111         111111111
1  <     11                   81
11111   11                    11
1    < <                   4   1
1 1111111111     R       1111111
1     11         111    1111   1
1      118        1    1111    1
1       111       1   1111     1
1        11       1  1111      1
1         3       1 <          1
1                 1111         1
1      4           1111        1
1 11111111111       1111       1
1  111111111         1111      1
1                5     1111    1
1       2    >   5         >   1
11111111111111111111111111111111

