11111111111111111111111111111111
1        1      3              1
1        1 2                   1
1        11111F111111111111    1
1 44         < >  81      31   1
11111  1111111F11111        1  1
111111       < >     4       > 1
1 11111   1111F1111111F111111111
1  11111     < >  4           31
1   11111F1111F1111111     4   1
1            1 1           4   1
1            1 1       111111111
11           1 1       1      11
111          111       1     111
13                    11      31
1                              1
1                          44  1
1111111F1111111111111 1111111111
1            4                 1
11111111111111111111111111111111
