$hint: Throw a white ball in every horizontal elevator.
$stonepattern: 1
11111111111111111111111111111111
1        3             111     1
1                       3      1
1        4                     1
1        4   4          55     1
1 111111111111111111  11111    1
1                  U 111111    1
1     L        1111 1111111    1
1                              1
1           R  1111            1
1                              1
1       R      1111            1
1     1111111                  1
1     113               5      1
1     11   11   1111111111111111
11111 1111111                131
131            U               1
1                F11145        1
1      4     2       4 111111111
11111111111111111111111111111111
