11111111111111111111111111111111
1                             11
1                             11
1                             31
11                             1
13                           111
1                           1111
11  R       11   4         11111
111     44  1111111111 111111111
1311    44                     1
1       44    5    4       11 11
1       44    5   111111       1
1      1111111111114  11       1
111111111111       4   11111   1
1      >           4         U 1
1 R    1FFFFF1FFFFF1FFFFFFFF   1
1  2 R 1     3                 1
11111111                       1
11111111                       1
11111111111111111111111111111111
