$hint: Fill the glide with white balls.
$stonepattern: 1
11111111111111111111111111111111
1    3                      3  1
1 4           44               1
1 4           44      4  5     1
1 111111 111111111-1111111111  1
1 5                          > 1
1111                        1111
1  11                      11111
1   11               2    111111
1    11          H11111111111111
1     11        HI             1
1      1 5     HI              1
1  44     5   HI               1
11D1111D 11111I                1
1                  5          11
1                  5         111
1                  5          31
1                  5           1
1       4          5           1
11111111111111111111111111111111

