$stonepattern: 1
11111111111111111111111111111111111
11111111                          1
11          44  2  4 44           1
11  1-111111111111111111111111    1
11    1111111                     1
11   11         R                 1
18    1            111            1
18    1            11  L          1
18    1                           1
11    1                          81
1     1                          11
1     1                          31
1  U  1                           1
1111  1                     5     1
13    1                           1
1   4 1   111 11111111 111111111111
1 11111  1111 11111111 111111111111
1 9      11111111111111111111111111
1      1111111111111111111111111111
11111111111111111111111111111111111



