11111111111111111111111111111111111
111                            1111
13                              111
1      1                44       31
111111    4             44        1
1       111111 111111111111111111 1
1                                 1
1                                 1
1                                 1
1      9                          1
111    4                111       1
1     111               111       1
1 1           U                   1
1           1111         1        1
1U         11111         1        1
1         111111         1        1
1                                 1
1      9  9  9     5              1
1               2   4     U       1
11111111111111111111111111111111111
