$bgcolor: 0, 0, 35, 22, #87CEEB
$fgcolor: 0, 0, 35, 22, white
00000000000000000000000000000000000                                   
1                               111
11G 4               11111111G    31
1111111              5 5   J1G    1
111131I     55      J1111    J11111
1              2        J11   11111
111 11111111111I          J1  11111
111 111111I                J1 J1111
111 1111I                       J11
111 111I                          1
111 111                      U    1
111 111                           1
111 111                           1
111U111                           1
111 111G                          1
111 1111G                         1
111 111111G                    4  1
111 111111        L          111111
111  J11111  G              H111111
111          1              1111111
111 1111111111              1111111
11111111111111WWWWWWWWWWWWWW1111111
