11111111111111111111111111111111111
11I                              31
13                                1
1         1111111111111111111111111
1    4                            1
11111111111111                    1
1 J1I       111                   1
1  3         111                  1
1 2           111                 1
111            111     111111111111
111             111     J1I      31
111                   5  1        1
111                   4           1
111       L         11111 111111111
111                H11111U111111111
111                111111 J1111I 31
111                111111  11I    1
111G             4                1
1111VVVVVVVVVVVVV111111111111111111
11111111111111111111111111111111111
