11111111111111111111111111111111111
1                                 1
1 1111111111111111111111111111111 1
1                                 1
1     4                           1
1   11111    R      5             1
1U4                  5         2  1
111111111               R     111 1
1                              J1 1
18                              1 1
11                              1 1
13                              1 1
1                                 1
11111111111111111 11111111111111111
11111111111111111 11111111111111111
11111111111111111111111111111111111
