$stonepattern: 1
11111111111111111111111111111111111
1                        3113     1
1                         11      1
1                      11111111   1
1                                 1
11111111111111 111111  111111 11111
1               1111111111111 11111
11           5     3111111111 11111
13   111111111      111111111 11111
1   11      11 1111 111113111 11111
1   4       18  4          11 11111
111111      1111411 111111 11 11311
111111          4       2        11
11111111111111111111111111111 11111
11                            11111
13                                1
1 4                               1
1 4                          U    1
1 111111111111111111111111111 11111
11111111111111111111111111111111111
