$stonepattern: 1
1111111111111111111111111111111111
11                               1
13                  111=         1
1                   1  =  4      1
1     4             5  111111=1111
1-1-1-1111111=1111111       1=1111
1 1 1 1      =           1111=  31
1 1 1 1      =           1   =   1
1 1 1 1      =        G  1   = 4 1
1 1 1 1111111=1111111 11111 1=1111
1 1 1      1 = 3       1    1=1111
1 1 1      1 =              1=1111
1 1 1      44=         1    1=1111
1 1 11111111111111111111    1=1111
1 1          111             =1111
1 1           3           111=1111
1 1                       8 1=1111
1 111111111111111111111111111=1111
1             2              =1111
1111111111111111111111111111111111
