11111111111111111111111111111111111
1                                 1
1                                 1
1                                 1
1                     4           1
1                     4    11111111
1                     4           1
18                 8111111111 11111
1I                 J1 3    11     1
1                          11     1
1    4                     11     1
1    4                     11     1
1  2 4                       U    1
1=11111-11  R  L   R       11 11111
1=       1                 11 11111
1=       1WWWWWWWWWWWWWWWWW11 11 31
1=       11111111111111111111     1
1=                                1
11111111111111111111111111111 11111
11111111111111111111111111111111111
