$stonepattern: 1
11111111111111111111111111111111111
1                                 1
1                        4        1
1     4     2            4        1
1  1111111111111      1111111     1
1  1           1     111   111    1
1  1 111111    1    11    4       1
1  1 1111  D D     11   111111111 1
1  1 1111   U U11111   11   111I  1
1  1 1111 H    1      11    J11   1
1  1 1111 1    1     111     11   1
1  1 1111 1 1 11    1111     J1   1
1  1 1111 111111   11111      3   1
1  1 1            111111          1
1  1 1 11111111111111111    111   1
1                           111   1
1 H1111111111111111111111111111   1
1      3               11111      1
1G        111  111       3        1
11       4     111                1
11111111111111111111111111111111111
