$stonepattern: 1
11111111111111111111111111111111111
1                                 1
1 1111111111111111111111111111111 1
1 1I                              1
1                      111111111-11
1                5                1
1 911111-11111-11111   11=111111111
1U 11111  131      111  1=      111
1 111111               81=       31
1         111         J11=        1
1  11=1  11111          11111 111-1
1  d1=< 5   11               9  1 1
1 2 1111111=111  11111111111111=1 1
111 1111111=111  11111111111111=1 1
111W1111111WwwwWWwwwwwwwwwwwwwwW1 1
111w1111111wwwwwwwwwwwwwwwwwww111 1
111w1111111wwwwwwwwwwwwwwwwww1111 1
111w1111111wwwwwwwwwwwwwwwww113   1
111wwwwwwwwwwwwwwwwwwwwwwww111    1
11111111111111111111111111111111111
