11111111111111111111111111111111
1                              1
1                              1
1                              1
1                              1
1                  4           1
1    p5          59555 55      1
1 559    5559  55     9    4   1
1  3    p    55  p 4 5   5559  1
1     55    5  2p 55 4  4 9    1
1   p       9p 9 5 9 5 45      1
1           5 p 5   5  55      1
1            5 5      5        1
1                              1
1                              1
1                              1
1                              1
1                              1
1                              1
11111111111111111111111111111111
