11111111111111111111111111111111
1      3                      =1
1          2   4           111=1
1G  111111111111111111     311=1
11G                   >     11=1
111G                 111111111=1
1111G               11   4    =1
11111G     4       11   111   =1
111111G    4      11   1      =1
1       H1111    11   1    11111
1      H1111    11   1       111
1     H11111   11   1        811
1    H11111   11   1         111
1   H1    3  11   1           11
1  H1       11   1     5      31
1          11   1      5       1
1  111    11  4            11111
1  1111  11  1111111   4   11111
1           111111111  4   11111
11111111111111111111111111111111
