$stonepattern: 1
11111111111111111111111111111111
1      3                      =1
1          2   4           111=1
1G  111111111111111111     311=1
11G                   >     11=1
111G                 111111111=1
1111G               1I   4    =1
11111G     4       1I   111   =1
111111G    4      1I   1I     =1
1       H1111    1I   1I   11111
1      H1111    1I   1I      111
1     H11111   1I   1I       811
1    H11111   1I   1I        111
1   HI    3  1I   1I          11
1  HI       1I   1I    5      31
1          1I   1I     5       1
1  111    1I  4            11111
1  1111  1I  11111111  4   11111
1           1111111111 4   11111
11111111111111111111111111111111