$stonepattern: 1
11111111111111111111111111111111
1              1    4        111
1              1  111111      31
1 4  2                 J1      1
1111111-111111111111    J1    11
111     1111              >  111
13       J18        111111111111
1         J1        11  9     k1
1                              1
1111111111111111111 1111111111=1
1           3       111I   3  =1
1      4       H11   l        =1
1 11-1111111111111111111111111=1
1             1111I         11=1
1             311I          11=1
1              <       4    11=1
1         11111111  1111111111=1
1    5   1111111111  111111111=1
1        11111111111     4    =1
11111111111111111111111111111111
