$stonepattern: 1
11111111111111111111111111111111
1      1111111      111       k1
1 11    11111        3         1
1 11                           1
1 1111   111    1111111111111111
1 1     9      5              31
1 >   2            4           1
1 111111111111111111111111111111
1        l                   111
111111-1111         5         31
1        311        5          1
1         111111111111111  11111
1   5                          1
1                              1
11111111111111111111111111111 11
1311      5                    1
1                           4U 1
1                 5         5  1
1                     4        1
11111111111111111111111111111111
