11111111111111111111111111111111
1                  3          =1
1   5        11111            =1
1   5       111131111         =1
1   5      111     1111       =1
1        4       4    5 11    =1
1     1111111  11111111 111111=1
1           11111    11     11=1
1           11111     1  4   1=1
1            1111     1 555  1=1
1            1111     1      1=1
1    D        111     1      1=1
1        4    111     1      1=1
1       555    3      1      1=1
1   5                 >       =1
1           111111111111111111=1
11141 5     111               =1
11141     1113                =1
1  4  2   111                 =1
11111111111111111111111111111111
