11111111111111111111111111111111
1=                             1
1=   55            5           1
1=                 5     4     1
1=     4       1111 11  11F    1
1=     4     5       1  1      1
1=1111111111-1       15 1      1
1=     4             1111      1
1=     4                       1
1=1111111F                     1
1=18            1111           1
1=11               3     99    1
1=                             1
1=1111111         5  11111111111
1=         5                   1
1=                             1
1=    55        5       55     1
1=     5        5       5      1
1=  4               2          1
11111111111111111111111111111111
