11111111111111111111111111111111111
1               3                 1
1    4         4                  1
1   1111       4                 81
1    5        1111              111
1  5          1111  55           11
1 111 111111111111  111111        1
1U111  11        3      111111    1
1 111  11                      4  1
1 111  11    111111           11111
1 111  11              2 4        1
1 111 1111 1111111111111111       1
1                 11111111111111111
1                    111111111    1
1                      1111       1
1                                 1
1    9       9                   11
1        9       9               31
11                                1
11111111111111111111111111111111111
