11111111111111111111111111111111111
1  T             111111111111111111
1  11   4 p p    111111111111111111
1  111111111111  111111311111111111
1                1   31     1    31
1                     5     1     1
1                11111111   1    11
1                     5     1   111
1                111111111111  1111
1                           >  1111
1                1111111111111p1131
1                                 1
1  4             111111111111111111
1  4                              1
111111                            1
1        5                        1
1        5                 T      1
1        5            1111111111111
1        4      2     1111111111111
11111111111111111111111111111111111
