11111111111111111111111111111111111
1=  5                1          J11
1=5                111           31
1=11 11111111-1111   1            1
1=       13         81      p     1
1=       1        1111    =11111111
1=       11       1       =       1
1=       1111111111       =       1
1=                        =       1
1=11                      =       1
1=                        =   T   1
1=111                     =11111111
1=                        =       1
1=                        =       1
1=             11         =      H1
1=             11         =      11
1=             11        9=      31
1=   H111      11         =       1
1=   1T 4      11  2      =   4   1
11111111111111111111111111111111111
