11111111111111111111111111111111111
1               4              1131
1    55     5   4       p         1
1   1111  1111111111111 111 11111 1
1G  11 1y4          Y    11 1111111
13  11   4     2         11 1     1
1   44 11111111111111    11U1     1
111111 1111111118        1  1     1
1   11 1113111111           1     1
1   11 1                 1111     1
1   1  1111111  11111111111       1
1   y          y                  1
1   yyyyyyyyyyy                   1
1   yyy                           1
1                                 1
1                                 1
1                             H1111
1G                         H1111111
11VVVVVVVVVVVVVVVVVVVVVVV1111111111
11111111111111111111111111111111111
