$stonepattern: 1
1111111111111111111111111111111111111
11                                  1
11 11111111111111111111111111111111=1
1   111111113114111111    1T   54 1=1
1   1          4     1    111 111 1=1
1     11 11111111111            1 1=1
11 11111111111131111111111111p111 1=1
1             <                 1 1=1
1       4   5 1=11111111111111111 1=1
1R     1111 111=1     4            =1
1             1=1=111111111-1   5 111
1           111=1=1         11111 111
1            81=1=18              111
11 111111111111=1=11111       4   111
1     = >    T1=1=13     55 11111 111
1     =11111111=1=1=1111111       111
1     = >       1=1=1111111       111
1     =1111111111=1              H111
1     = >         1111            111
1     =111111111111               111
1  2  = >             111111 11111111
1111111111111111111111111111111111111
