11111111111111111111111111111111111
1                                 1
1      R           111=11111111 111
1  9         5        =           1
1            5        =           1
1 9                   =     1111111
111111111111          =           1
1 3 1                 =        4  1
1   B                 =      1111=1
11111111              =      B 8 =1
1       4          1  =      1111=1
1=1111111111       1  =  4       =1
1=1                111111111-1111=1
1=1                            31=1
1=1                       55    1=1
1=1             b            1111=1
1=1            111          113  =1
1=1   111      111  5       1    =1
1     111       4     2          =1
11111111111111111111111111111111111
