1111111111111111111111111111111111111111
1 3  11111111111111111111111111111111111
1                                     11
1b   5  4     p p           2      4E 11
11=1111111  11111111111111111111   H1 11
11=11                 11          H11 11
11=11                 11         H111 11
11=1111111111-1=11111111        H1111 11
11=1111114111 1=1111           H11111 11
11=111111B111 1=13 1          H111111 11
11=11         1=1  l         H1111111 11
11=11 111111111=11111 11  11 11  3 11 11
11=11      4          11  B        11 11
11=1111111111111111-11111-11-11111111 11
11=11111k11114111    8111 11       11 11
11=>        1B111    1111  JG      11 11
11=1111111     11    1111G  JG     11 11
11             11        JG  JG    11U11
11111=11        3   111   JG  JG   11 11
11111=11          5  11    JG  JG  11 11
11111=1111111111 5   11     JG  JG    11
11111=111111111              JG  JG   11
11111=1111111111111111111111111   JG  11
11111                         <    JE 11
1111111111111111111111111111111111111111
