$stonepattern: 1
11111111111111111111111111111111111
1           1111   111111         1
1            111   11111          1
1             11 4 1111           1
1              3 4 3 Y            1
1    =9999       U       9999=    1
1 T2 =                       =   T1
1 11111111111         1111111111111
1 1118                         8111
1 1111                         J111
1 1111G          G              111
1 1111111                       4=1
1 1111         R               11=1
1                              31=1
1111111yyby   y111 1111111111     1
111    yy1y  yy  1 1       1111yy11
11I    yyyyyyyy  1 1              1
13     yyyyyyyy  1B1              1
1          5                      1
1                                 1
1111 111111111111111111111111111111
11111111111111111111111111111111111
