$stonepattern: 1
11111111111111111111111111111111111
11111444444444444444444444411111111
11111444444444444444444444411111111
11111444444444444444444444411111111
11111BBBBBBBBBBBBBBBBBBBBBB11111111
1                          11111111
1                          11111111
1                          11111111
1                          11111111
1                          13111111
111                        1     11
1                          11111=11
1 EG                       5    =11
1U11       1E    R         11111=11
1 11E  R    1              11111=11
1 111                      81   =11
1 113                      11   =11
1 11                        5 4 =11
1 111                      11111=11
1  81                      11111=11
1 111     b  2                  =11
1 111111111111111111111111111111= 1
1                                 1
1 111111111111111111111111111111111
11111111111111111111111111111111111

