$stonepattern: 1
11111111111111111111111111111111111
13                               11
1                                31
1   5                             1
1 5                       O       1
1111111-11111111111111111111111=111
18                    111111311=111
11                    J1I         1
11                           1111 1
11                      E1114     1
11                          5 11111
11                          1111111
13             O 2 O             31
1          111111111111           1
1         H111111111111U          1
1111111 1111111111111111111111 1111
11111111111111111111111111111111111
