$stonepattern: 1
11111111111111111111111111111111111
1                               1O1
1                               1B1
1                                 1
1                                H1
1-111111111111111111 11111111111111
1                   p             1
1G              9                 1
11111111111111111111111-111111111=1
13                               =1
1                         1111   =1
1                       55 1  4  =1
1yy11111111111111111111y1111 1111=1
1yy               Y        1b1   =1
1Gyy            2          111   =1
11 111111111111111111111         =1
13                11311111111111111
1                                 1
1                    y            1
11111111111111111111111111111111111
