11111111111111111111111111111111111
111111111111111111111111111111    1
111111                          E 1
11111                     L    E1 1
18                111111G         1
1I                     J11111     1
1            5          J1313     1
1         4                4      1
1      1111111111=111 11111B11    1
1                =                1
1                =                1
1                =                1
1                =               U1
1                =                1
1                =              4 1
1       4        =             1E 1
1      11   9    =             1111
1          1     =      5      1131
1     b          =  2             1
11111111111111111111111111111111  1
11111111111111111111111111111111111
