$stonepattern: 1
11111111111111111111111111111111111
13                                1
1                   U             1
1   24                            1
111F111p            5   4     1   1
1                    1111111  1 1=1
1       9                       5=1
1       1                    1111=1
1       9                    8111=1
1       1            1G      8111=1
1       9                    1 31=1
1       1G                      1=1
1       9                    4  1=1
1       1     55            11111=1
1       9                   11111=1
1       1                5     31=1
1       1                       1=1
1       111111111111 111111111111=1
1            3     1 1          1=1
1                  1 1          1=1
1         5        1 1          1=1
1         5        111          1=1
1                                 1
11111111111111111111111111111111111
