1111111111111111111111111111111
1k                     111113 1
1                           4 1
1                          11 1
11111111                   11 1
1                          81 1
11 11                     111 1
13 11                       1 1
1   1                       1 1
11  1                       1 1
111 1                   11111 1
1  55 11   111111111111111311 1
1      1    l  >              1
11111 1111111111111111111111111
1X                           31
1                             1
1111                   111 1111
1111         p   9         1111
1111         5      2  11111111
1111111111111111111111111111111
