$stonepattern: 1
111111111111111111111111111111111111
113       13     813          1    1
11             1111           1   11
11   9   5        1           1    1
1                 1           1 HE 1
1 111111111111111 11111111111 1 1  1
1 1   1         1 1        44   1  1
1 1 1 1 1111111 1 11111111 111111  1
1 1 1 1 1       1 11111111 1       1
1 1 1 1 1 1111111 11111111 1 HE    1
1   1   1       1       44   1     1
111111111111111 11111111111111     1
111111  4                    1     1
111111  11111                1     1
11111   4                    1     1
11111   11                  11 D   1
11111   4                   31     1
11     11                    1     1
11    118                    1     1
11  11111                         D1
11  111     111111111111111111     1
11   11  H                         1
11    1  1E      L           E     1
11    1                       E    1
11    1                       11   1
11    1G                           1
11    11E         R             E  1
11    111111111111111111111111111E 1
111                             1111
11X                               31
11               2                 1
111111111111111111111111111111111111
