11111111111111111111111111111111111
1                           o     1
11 o                   9          1
18                            11  1
11                             1  1
1                                 1
1                                 1
1                            4 1  1
1                           1111  1
1                   5 1           1
1                 11111     1     1
1                  131     11     1
1                          81     1
1          111             11     1
1  o       13              81     1
1          111            111     1
111111                            1
1X   1                            1
1  2 >                            1
11111111111111111111111111111111111
