$stonepattern: 1
11111111111111111111111111111111
1    11               11       1
1    1C     4         c1       1
1       =11111111111=          1
1       =l    3     =         11
1       =1          =         81
11      =11111111111=5        11
1k      =           =1         1
1                9  =          1
1    55  11F11111111=          1
1    5              =          1
111111c         2   = C1   4   1
11111111111111111111111111111111
