$stonepattern: 1
1111111111111111111111111111111111111
1111111111111111111111111111111111111
1111111111111111111111111111111111111
131111=4        c  1     C   c      1
1   11=C           1                1
1     =     1      1      1         1
111 55=     T      1      1         1
111111=1  111      1      1         1
111111=1   11      1      1         1
111111=    11      1      1   5     1
111111=    11      1      1   5     1
111111=    11      1      1         1
111111=    11      1      1         1
111111=    11      1      1         1
1   11=    11      1      1         1
1 4   =    11      1      1         1
111111=    11      1      1    p 4  1
111111=    11      1      1   1F111=1
1   11= 9  11      1      11    131=1
1 b   =    11  c          18       =1
111111=  2 T1  4         C11     4 =1
111111=111111111111=111111111B11111=1
111111=11        11=11           11=1
111111=            =               =1
1111111111111111111111111111111111111
