11111111111111111111111111111111111
1=4                               1
1=1    p                          1
1=     p                          1
1=     p                          1
1=     p           55            11
1=111111111111                   31
1=                                1
1=C                               1
1=                           111111
1=                                1
1=                                1
1=                                1
1=                 1111111        1
1=                 1              1
1=                11              1
1=                                1
1=                                1
1=  2c 9 9 9 9 9 9 9            C 1
11111111111111111111111111111111111
