11111111111111111111111111111111111
13                           4   c1
1  11111111                  4    1
11=                      1111111111
11=pp                             1
11=        4                     c1
11=pp      4                      1
11=        4     11111111         1
11=pp      4   1-1                1
11=    55 111111                  1
11=pp  11111111                   1
11=        111         11         1
11=pp      111        118         1
11=         11       1111         1
1      5    1        1111         1
1    + 5    1        113          1
1   4       <                     1
11111111111111       111111111111 1
11111111111111  2  4    9        C1
11111111111111111111111111111111111
