11111111111111111111111111111111111
1         31                      1
1          1           5          1
1        111           5          1
1       55                     E  1
1=1111 55             R       E   1
1=1111111                         1
1=18                              1
1=18                           4  1
1=111                          4  1
1=13Ć                          4  1
1=1                        1   4  1
1=111v1111                 1   4  1
1=1     11                 1   4  1
1=1     31                 1   4U 1
1=1      1                 1   4  1
1=1      5        4        1   4  1
1=1111111 11111111111      1^1v1  1
1               2   4           1 1
11111111111111111111111111111111111
