$extra: 1
$stonepattern: 1
11111111111111111111111111111111
1                            c 1
1 1111111                      1
1 1                            1
1 1C          9    c           1
1 1  111111111111111           1
1D1  C                         1
1 1   1                        1
1 1   1C                       1
1 1 1 1                        1
1 1 8 1c                       1
1 1 1 1                        1
1 1   1C                       1
1 1   1                        1
1 1   3                        1
1 1                            1
1     1 1                      1
1                              1
111c C1     4     2         +  1
11111111111111111111111111111111
