$extra: 1
$stonepattern: 1
11111111111111111111111111111111
18                            31
11311111                       1
1        1 1111111 11111111p11p1
111111D1 1 1              1    1
1   31 1 1 1      D       1    1
1    1 1 1       811      1111 1
1   11 1 1  1111111111    1    1
1 4    1 1             44 1 1111
111111 1 1  111111111111111    1
13     1 1    311         1111 1
1      1 1 D        11111 1    1
111111 1 1 1111111111111  1 1111
13     1 1               D1   31
1      1 1  111141111111111  4 1
111111 1 1   1113111111     1111
1      1 1cD   9         4     1
1 4 2  1 1111111111111111111   1
111111 1                     4 1
11111111111111111111111111111111
