$stonepattern: 1
11111111111111111111111111111111
1                            3 1
1                              1
1   111                     4  1
1 4   11                   111U1
1111   1    4               81 1
1    4 1 54 1111    LL   11111 1
1   1111111                    1
1 4    13                      1
1111   1       111          55 1
1    4 1 4    U   1         55 1
1   1111111       1         55 1
1 4   31     5    1         55 1
1111   1     5    1         55 1
1    4 1     5    1         55 1
1   11118                      1
1 4    1111111111          111 1
1111    1   1   1 1      1113111
113  4    1   1   1 2  4       1
11111111111111111111111111111111