$extra: 1
$stonepattern: 1
11111111111111111111111111111111
1  13                          1
1  1   11             4        1
1  11111 5            55       1
1         111          55      1
1          4                   1
1       11111111              11
1D     11                     31
1         5                    1
1 1111111111 11111111111111111 1
1 18                           1
1 11        4                 11
1        11111                31
1   11                     5   1
1   13   1                 5   1
1   1    1111111111111   1111111
1   11   81        p           1
1    111 11        p       p   1
1            4 2               1
11111111111111111111111111111111
