$extra: 1
$stonepattern: 1
11111111111111111111111111111111
1 3                         8111
1    11111    5             11 1
111111        5    4           1
1          111111  4  111  111 1
1               11111        1 1
1 4 4   1111111     11 9   C 1 1
111111    111111111 1111111111 1
1 3       55 1    <  >       1 1
1v11  p   55 11111111111 11111 1
1    1111155U1  <    <    >  1 1
1 5  4   111 1 1111111111111 1 1
1v11 4     1 1 >  1      <   1U1
1    111   1 1111111 111111111 1
1 4        1 1  3          4   1
1v111111^111 1111111111111111  1
1  3> <    1                  81
1v11111111^1                1111
1                  c  2  9 11111
11111111111111111111111111111111

