$extra: 1
$stonepattern: 1
11111111111111111111111111111111
1                              1
1                              1
111                            1
1 <                           11
1 1111111111111111111111      31
1                      11      1
1                       11   111
1  4 4 4 4 4 4    1      11^1131
1 1111111111111 111            1
1   1  31     4 481     11111111
1   1^111     4 411   111      1
1D  5       5 4 4              1
1   5         4 4              1
1 91111111111 4 4 11111111111  1
1             4 4              1
1             4 4              1
1             4 4              1
1     2       1 1              1
11111111111111111111111111111111
