$stonepattern: 1
11111111111111111111111111111111
13      184                    1
111   5 11B1               b   1
1   11111  11111         11111^1
1    4       3 1 c         c   1
1111111    5   111   111111 11^1
1  4       5   111 111   >     1
111B11  11 11111     11^111 11^1
1       1111  4      1 44      1
11^1111113    4      1^111191111
1      4     111111  1         1
1^1111B111 4         111111111^1
1        1111          1       1
1^1111  11     5 11111 1111111^1
1       31     5   1           1
111v11   1     5   1     1111111
1   >    1  2   U  1     5   3 1
1^111111111111111111     5     1
1                  <           1
11111111111111111111111111111111
