$extra: 1
$stonepattern: 1
11111111111111111111111111111111
111C   9                c      1
11     4                      81
111 11111 11111111111111 1111111
111 1   2       11  3          1
111   1 p       1T 4      5    1
11  1111111G    1111      5    1
111 1      JG     1  1         1
111 1       JG    1 H1         1
11141        JG   1 1  1      H1
11141             1 5  1      31
11141          H11111111       1
111D1         HIC        1111111
111 1        HI               81
111 11                        11
111 1T   c      4             11
111 11111111 1111111111111111111
111                            1
111 11111111 1111111111111111111
111                            1
11111111111111111111111111111111
