$stonepattern: 1
11111111111111111111111111111111
1                          c   1
1  9                           1
1                              1
1                     11       1
11 11 R                1       1
1       11111141111            1
1            1B1  3            1
1        1       11           81
1       11111111111  b        11
1   5             111111111 1111
1   4      C             1     1
11U11111    5            B C   1
1    111111111111 111111111 1111
1    1       111              81
1             3               11
1                              1
1         111111               1
1    1        2  C1            1
11111111111111111111111111111111