$stonepattern: 1
11111111111111111111111111111111111
1             5 5               4 1
1 9                             9 1
1 9                             9 1
1 9                             9 1
1 9                             9 1
1                    1  111       1
1                    1 4  1       1
1       1            1111 1       1
1       3                         1
1U                               U1
1       1111                      1
1      11                         1
1     11                          1
1                                 1
1                                 1
1                        U        1
1   9        p99999           9   1
1        2                        1
11111111111111111111111111111111111