$stonepattern: 1
111111111111111111111111111111111
1                !              1
1   4                           1
1   4                           1
1   55                          1
1                            11=1
1     p                5     11=1
1                      5     11=1
1  U             1           11=1
1      111111111111111111111111=1
1     !!!!!!!!!!!!!!!!!!!!!!!!1=1
1                             1=1
1                             3=1
1 2                             1
11111      R                  111
11111                         111
11111WWWWWWWWWWWWWWWWWWWWWWWWW111
11111wwwwwwwwwwwwwwwwwwwwwwwww111
11111wwwwwwwwwwwwwwwwwwwwwwwww111
111111111111111111111111111111111