$extra: 1
$stonepattern: 2
111111111111111111111111111111
1         1 T              < 1
1         3 1             H1 1
1           1 b     4    H11 1
11        11111     B   H111 1
1T  2                  H1111 1
11111111               11111 1
11111111               5   < 1
11111111---------------11111 1
1             4           81 1
1             4     5     11 1
1             ! 5           U1
1                 5          1
1                  5         1
1                            1
1               11111111111111
1  5                       131
1  5                         1
18                           1
111111111111111111111111111111