$extra: 1
11111111111111111111111111111111
13                             1
1                        5     1
1    5   2              4      1
1111111111111111 111111111111111
13  11                        11
1   1   L                      1
11                            H1
11                       5    11
1111111 R                      1
1                              1
1  55                          1
1 55555      HG  HG            1
1   55       11VV11            1
1           H11VV11G           1
1           111VV111           1
1          H111VV111G          1
1         H1111VV1111          1
1         11111VV1111          1
18       H1111VVVV1111G       81
1111111111111VVVVVV1111111111111