11111111111111111111111111111111
1                       11111111
1                       1 k   81
1                11           11
1               11 9    111    1
12 5     p    4       C        1
11111 111111 1111111111111111  1
1  3      81 1       1         1
1         11 1    4  1         1
1      5  13 111 111=1         1
1     5  91  111 111=1         1
1         l         =1         1
11=1111111111111111111         1
1 =         81                 1
1 =        111                 1
1 =      55                    1
1 =          5                 1
1 =       U  p                 1
1 =                            1
11111111111111111111111111111111
