$extra: 1
$stonepattern: 1
1111111111111111111111111111111
1                             1
11      R                   111
11             1             81
13     p       y           1111
1              1           3  1
11             1              1
11      5      11        p    1
1τ      5      1T 5  4        1
1111111111111111111111yy1111111
1     C        +             31
1       55                    1
1        55        p    2     1
1                         4   1
1              11111111111111 1
1             11              1
1     9       Y1              1
11             11             1
1T             1τ             1
1111111111111111111111111111111