$extra: 1
$stonepattern: 1
11111111111111111111111111111111
1           111                1
1            3                 1
1                              1
1           p     p            1
1        4           2         1
1      1111111111111111111  1111
1                              1
1                              1
1 4 p                          1
111111111  111111111111111  1111
1                              1
1                              1
1                              1
1                             11
1               s             31
1          111111111           1
1         111111111111    5    1
1   s   111111111111111        1
11111111111111111111111111111111