$stonepattern: 1
11111111111111111111111111111111
13                             1
1                              1
11                             1
11   4           9 9 9 9 9    11
11   4       5   4            T1
111111111 1111111111111111111111
1                  1α         β1
1                              1
1                              1
1                              1
1                              1
1                              1
1                              1
1                           1  1
1                           3  1
1                              1
11                      11111  1
1T           2   4         8  α1
11111111111111111111111111111111