$extra: 1
$stonepattern: 1
11111111111111111111111111111111
1                              1
1                              1
1      U1   U1111111111 11111111
1       1    1        1        1
1s      1    1             55  1
11111111111111              1  1
1                        9     1
1                              1
1                         4    1
11           1111111111 11111 11
13                             1
1                    p Δ   2   1
111111111111  111111111111111 11
1                            U 1
1                              1
1                              1
1        5                     1
1                              1
11111111111111111111111111111111