$extra: 1
$stonepattern: 1
11111111111111111111111111111111
18                            β1
11                 4   4       1
1                  4   4   111 1
111111=111áäääääà1111111111131 1
1     =          111           1
1  5  =                        1
111111=          111   1111111 1
1     = 4        11111111      1
1     =111111111111111111      1
1     =                       α1
1   11111                     11
1^111 3                 Á      1
1                       ä      1
1         5             ä      1
1         5             ä      1
111111    11111=1       À      1
1              =               1
1       5      =  áääà         1
1          4  2=               1
11111111111111111111111111111111