$extra: 1
$stonepattern: 1
11111111111111111111111111111111
1=111   3        k     111111111
1=11C                  9      T1
1=11 1111111111y1111111111111111
1=11 1  Y1α                   81
1=11 1^1y1          111=11111111
1=l               c1131=11  1111
1=11111111       1        4    1
1=             111  1111111111 1
1=1111yy111111111  11111111111 1
1=11111111111111        1 3  y 1
1=1111111111111         1      1
1=111111111111          11111111
1=             ÁÁÁÁ            1
1=1111111111111ääää            1
1=      p      ääää            1
1=1            ääää            1
1=1            ÀÀÀÀ     5     11
1   2                   4     T1
11111111111111111111111111111111