$stonepattern: 1
11111111111111111111111111111111
11    31                       1
1T     l                       1
11111111=11                    1
1       =                      1
1       =                      1
1       =                      1
1       =                55    1
1       =            11111111111
1      1=11          11111    Y1
1                          55  1
1                    11111111111
1                    11111    k1
1                    11111     1
1111        5              4   1
1T >        5        11111111111
111111111   5        5         1
13     111111111     5         1
1   4      π  2                1
11111111111111111111111111111111
