$stonepattern: 1
11111111111111111111111111111111
1        α       β   α        β1
1                       α β    1
11                             1
1   β                          1
1                α             1
1            β                 1
18             β               1
1U     β                       1
1                      β       1
1                         α    1
1                             α1
1  β                           1
1                              1
11                             1
1                              1
1                           8111
1                           1131
12       11   11   11          1
11111111111111111111111111111111