$extra: 1
$stonepattern: 1
11111111111111111111111111111111
1                              1
1Φ11111B111                    1
1    18   1                    1
19B1 11            b           1
1 4               111          1
1 4                            1
1 4                            1
1 4                            1
1                              1
1 Ω                            1
1                              1
1         1                    1
1         Λ            11ω     1
1111                           1
13                      p      1
1                  2    p  4 4 1
111Φ       111111111111Ω11111111
11111111111111111111111111111111
11111111111111111111111111111111