$stonepattern: 1
11111111111111111111111111111111
113                4           1
11        =1111    4           1
11=1      =    Á   4 2         1
11=1  5   =    ä11111111       1
11=1   5  =    ä               1
11=1      =    À               1
11=1      1Φ11                 1
11=1                           1
11=1         1                 1
11=1          Δ                1
11=1        Ω111               1
11=1           Φ               1
11=1           11111111111111  1
11=1                        3  1
11=1                           1
11                            φ1
18                            φ1
18                            φ1
18                            φ1
11111111111111111111111111111111