$stonepattern: 1
11111111111111111111111111111111
1             1111111          1
1              11111           1
1              11111           1
1               111            1
1               111            1
1                1             1
1                3             1
1111                        1111
1111C                      c1111
11   C                    c   11
13     C                c     31
1                5             1
1^v1   1111^1111111111^11   1^v1
1     c          9       C     1
1^v1  11111^1111111111^111  1^v1
1  c             9          C  1
1^v1 11111^1v11111111v1^111 1^v1
1    c        2  9        C    1
11111111111111111111111111111111