11111111111111111111111111111111
11                             1
11                             1
11           Ψ                 1
11                             1
11          Ψ                  1
11                             1
11         Ψ     1             1
11               3             1
11                             1
11            1111             1
11                             1
11                  9Ψ         1
11                9Ψ        b  1
11       11     9Ψ         111^1
1Ψ9                            1
1Ψ9B                    99999v^1
11       5                     1
11ψ     4      2        11111111
11111111111111111111111111111111