11111111111111111111111111111111
1                              1
1                              1
1                              1
1                              1
1                          11111
1                          1  31
111111111111    1          l   1
11111μ1131j1    1        1111111
1T              1        111   1
111 11111111    1       1111   1
131^1     1     1             b1
1         1 11111      111111111
1  1      1   k        T1      1
11111     1     111111111      1
1         1         1          1
1         1         1       8111
1            ppp    1       1131
1             2   4 B  11      1
11111111111111111111111111111111