11111111111111111111111111111111
1     C              3        c1
1            11111-1           1
1               11 1111^19     1
1b           ψ     Ψ          C1
111111B111111111B1911 1111111111
1 3    118          1^1        1
1      u11                     1
1  2             1             1
1 1111B1111 11=1c C1   1111111 1
1D   1        =     ppp        1
1    3        =1         4   1 1
1           11=111111111111111 1
1          D> =λλλλ          1 1
1           < =              1 1
1 111111111111111111      1111 1
1   1                     1   U1
1   <               U     >    1
1   <     s  s  s      s  >    1
11111111111111111111111111111111