$extra: 1
$fgcolor: 1, 1, 30, 18, #4D301B
$fgcolor: 22, 17, 1, 1, black
$fgcolor: 5, 6, 1, 1, black
$fgcolor: 1, 9, 27, 1, gray
$fgcolor: 29, 9, 2, 1, gray
$fgcolor: 7, 14, 1, 1, gold
$bgcolor: 1, 1, 30, 18, lightblue
$bgcolor: 7, 14, 1, 1, #00005A
11111111111111111111111111111111
1               P              1
1               9             31
1                              1
1                              1
1   λ                          1
1   Áud    4 áäääääääääà       1
1  11111  11111111111111   5   1
1  1   1   1          1    5   1
1-11111111111111111111111111=111
1                 P         =  1
1                 9         =  1
1 5                         =  1
1111=1111                   =  1
11wwwwwk1                   =  1
11fwwwww1 1               1 = 31
11wwfwww1 1   111111111  21 =  1
111111111 111  1  3  1j 111 =  1
11      1 1 1  l     1  1 1 =  1
11111111111111111111111111111111