$stonepattern: 1
11111111111111111111111111111111
1 1       Ψ1                   1
1Ψ9       91                   1
1                              1
1   111                        1
1    3                111=1111c1
11                       =     1
1 Ψ     5  5             =     1
1111111111 11         111=     1
1                        =  9  1
1                      óò=1111 1
1                        =     1
1                      óò=     1
1                        =     1
1                   óöööò= ψ   1
1                        =1111 1
1           Ó Ó Ó        =     1
1^v       C Ò Ò Ò        =     1
1             2          =    C1
1v1111111111111111111+1111^11111
1                              1
11111111111111111111111111111111