11111111111111111111111111111111
1                              1
1                              1
1=1111111                      1
1=                        5    1
1=       111111111111111 111=111
1=                     óöööò=  1
1=111111               óöööò=  1
1=                 11 1111111111
1=           α     81 1        1
1=                 1  1        1
1=                   HI        1
1=                  HI        11
1=                 HI         31
1=                HI           1
1=               HI     11 11111
1=+                           +1
1=     5          11 11111111111
1=Σ 2 4                       +1
11111111111111111111111111111111
