$stonepattern: 1
1111111111
1      4=1
1   p  1=1
12      =1
11   p p=1
13 1   1=1
1  11111=1
1       =1
1    4  =1
1111111111