$stonepattern: 1
1111111111
1=      21
1=1  pp111
1=1    481
1=11   481
1=131  411
1=1 4  411
1=  11 5 1
1=    4  1
1111111111