$stonepattern: 1
1111111111
18  4   31
11  4    1
119 4   11
1   2    1
1  11111=1
1       =1
1       =1
1        1
1111111111