$stonepattern: 1
1111111111
1       31
1  4  11v1
1^111  > 1
1   1111=1
111    1=1
13   5 >=1
1   1111=1
1 4213   1
1111111111