$stonepattern: 1
11111111111
1 T13     1
1 t       1
111  p    1
1   24    1
1   1111p11
1  13  < 11
1      1 T1
111    1 11
111    1 11
11111111111