$stonepattern: 1
11111111111
1  11    31
19 11     1
1  t = 4  1
1  15=11111
1c   =13  1
11G  =    1
113  =    1
1    =    1
1  21= H  1
11111111111