$stonepattern: 1
11111111111
1 t       1
1 1111111 1
1 13    Jt1
1 11      1
1 5     9 1
1       9 1
1       9 1
1t 99 9=  1
1   2  =t 1
11111111111