$stonepattern: 1
11111111111
1 hh4  hh 1
1=9 1111 =1
1=  1131 =1
1=       =1
1=      9=1
1=9      =1
1=1     1=1
1=1 5   1=1
12hhhhhhh 1
11111111111