$stonepattern: 1
11111111111
1  2    <=1
1-1111111=1
1 >  p  1=1
1-111  3>=1
1 1 3 111=1
1 >     >=1
1-11p9111=1
1 18   31=1
1  > 4  >=1
11111111111