1111111111
1   + C c1
1     =  1
11    =  1
13    =  1
1     =  1
1 2 9 =9 1
1 1   =  1
1 1 c C +1
1111111111