$stonepattern: 1
1111111111
11      31
11       1
11=1111111
11=     81
11=     81
11=     81
1°      11
1  92 9991
1111111111