1111111111
1  55    1
1        1
1    .   1
1 5      1
111      1
113     81
1°      11
1 92  9991
1111111111