11111111111111111111111111111111111111111111111111111111111
1            3                                 =     C  c 1
1            111111                            =          1
1                 3                  9         =          1
1                   =    C        3 1 1        =3   3     1
1                  11111111            <       =          1
1                 11 3              11111111111= 1111     1
1    3           11      99               1    =         81
1            p  11        5               1    =         81
1   9111=91111Ψ11111 111111               1    =         81
1       =     3              9            1    =         81
1       =               5                 1    =         81
1       =           5                     1    =         81
1       =        1111111111               1    =        111
1 3     =                            3    1    =         81
1       =      9                          ~    =        111
11 1Ψ   =                            9      τ  =          1
1  1    = C                          1111111111=         31
1 τ1    =                         99           =          1
1ψ 1    =                                      =         21
1111111111111111111111111111111111111111111111111111111111@