111111111111111111111111111111111111111111111111111111111111
1         3                                                1
1                                                          1
1T 2          4                                   1 p      1
111111111111111111111111111111111ER                1       1
1                                                          1
1     O                                                    1
11111111111D                          9                    1
1                                    1 1                   1
1            G                                             1
1            1111111111111111                              1
1                   3                          11          1
1                                        4     18  1       1
13               111111     11111111 111111111111          1
1                111111     111111111111111111111         31
1111F1       p               13                            1
1                            <                           111
1111111-1111111111111111111111111111111111111111        1111
1                9                                      1111
1              11                                         31
1         5    111                                    5    1
1T                <                                        1
11111111111111111111111111111111111111111111111111111111111@