11111111111111111111111111111111111111111111111111111111111111
1                                                            1
1                                                            1
1               111111111111111111111111111111111111111 111111
1               1        3                    1           3  1
1               1   5                         1         5    1
1               1   5                         1         5    1
1     4         11111111                      1              1
1    44         1             R        1    4 1              1
11111111111111  1             L      1     1111              1
1        3   1  8                    1              4      4 1
13           1 1111111111111111111111111111111111111111 111111
1                               3                            1
111 111111111111111111111111                                 1
1                               1                            1
1                           U   1                     9      1
1     4  9                      111                 4  U     1
1   FF1FFF1                111111111              1111111    1
1    4    1                        1  5          5           1
1F11F1F   1         5              1         5               1
1 2  4    1                                  5               1
1111111111111111111111111111111111111111111111111111111111111@