$displaysize: 96, 60
$stonepattern: 1
111111111111111111111111111111111111111111111111111111111111111111111111111111111111111111111111
1     1                     4                                                 1111111111111    1
1     1                     4                                                     3    1111 11 1
1     1  R             R  1111111111                                                           1
1 8                       11                                                  111111111111111  1
1 11                                                                                    11111  1
1 11   11111 1111111                                                                     1111  1
1 11      3       111                                                                     111  1
1                 1111              U                                                      11U 1
1  111111111111111111111111111111111                                                        1  1
1                                   5                                                       1  1
111111111111111111111111111111111111 1111                                                   1  1
1      3                              1111                                                  1  1
1                                     11111                                                 1  1
1     11          5                   111111                                                1  1
1     11      11111111                1111111                       5 5 5 5 5 5 5 5 5 5 5 5 1  1
1     11      111111111               11111111                     5 5 5 5 5 5 5 5 5 5 5 5 51  1
1     11 999991111111111              111111111                     5 3 5 5 5 5 5 5 5 5 5 5 1  1
1     11                              111111111                    5 5 5 5 5 5 5 5 5 5 5 5 51  1
1     111111111111111111111111111111111111111111111111111111111111111111111111111111111111111  1
1     111111111111111111111111111111111111111111111111111111111111111111111111111111111111111  1
1                3                                                                         31  1
1                            5                                                 4            1  1
1111111111111111111111111111111111111111111111111111111111111111111111 1111111111111111111111  1
1                                                         11111111                       1111  1
1                                                          1111111                       1111  1
1                                                           111111                       1111  1
1                                                           111111                       1111  1
1                                                           111111                        111  1
1                11111                                       11111                        111  1
1                 111                                        11111                         11  1
1                  1                                          1113                          1  1
1                  3                                          111                           1  1
1111                                                          111    4              4       1  1
111                       5                                   11111111111  111111111111111111  1
11                        5                                   111111111111  11111111111111111  1
11                        5            55                     1111111111111  1111111111111111  1
13           111111 1111111111111111  1111                    31111111111111  111111111111111  1
1            111111 111111111111111  111111                    11111111111111  11111111111111  1
1111111111111111111111111111111111  111111111111111111111111111111111111111111  1111111111111  1
111111111111111111111111111111111  11111111111111111111111111111111111111111111  111111111111  1
11111111111111                    11                                          11            1  1
11111111111 3                    11                                            111111111111 1  1
1                               11                                                        1 1  1
1      5       5               11                                                         1 1  1
1   111111111111111           11                                                          1 1  1
1                        111111                                                           1 1  1
1   11111                                                                                 1 1  1
1   11111                                                 111111111111111111111111111111111 1  1
1   11111                                                1111111111111111111111111111111111 1  1
1   11111                                               11                              3   1  1
1  U11111                                               11                                  1  1
1   11111           9  9  9  9                          11    111111111111111111111111 111111  1
1                                  4                    11                          4       1  1
111111111    R      1111111111111111111                 11                     111111111111 1  1
1                                     11          11111111                    11            1  1
1                                     111         11111111                   11             1  1
1                                     1111             3                    11              1  1
18                                    11111                                11               1  1
1111111111111111111111111111111111111111111111111111111111111111          11                1  1
1111111111111111111111111111111111111111111111111111111111111111         11                 1  1
1        3                                                              11                  1  1
1                                                  5                   11                   1  1
1 111111111111111111111111111111111111111111111111111111111111111  111111                   1  1
1 11111111                                1111                     55                       1  1
1U11                                       111                     111                      1  1
1 11                                        1                        11                     1  1
1 11                                                                  11                    1  1
1 11                   4                                               111111111111         1  1
1 11     11111111111111111111111111111111111                                   4            1  1
1 118                  4     111           1                                11111111111111111  1
1 111                  4         4          U                              111111111111111111  1
1         1111111111111111111111111111111111                              1111111111111111111  1
1                                                                        11111111111111111111  1
11111111                                    1111111                     111111111111111111111  1
1                                                 4                    1111111111111111111111  1
1                                   1111111111  11111111              11111111111111111111111  1
1         5 5                      1111111111  1111111111            111111111111111111111111  1
1  4 4                            1111111111  111111111111          1111111111111111111111111  1
1111111111111111111111111111111111111111111  111111111111111111111111111111111111111111111111  1
111111111111111111111111111111111111111111  1111111111111111111111111111111111111111111111111  1
1111                              3        111111                                           1  1
1111                                      111113                                            1  1
1111                        1111111111111 55                                                1  1
111                        11             1111111111111111111111111111111111111111111      11  1
11                        11                                               11111          111  1
13                       11                                                 111          1111  1
1                       11                                                   1           1111  1
1111111     R     1111111                                                    1           1111  1
11111111           111                                                       1            3 1  1
111111111                                      11111111111                   1              1  1
111111111111      11111111111111111111111111111111111111111                  1        55    1  1
111111111111                                              11                 1        55    1  1
11111111111111111                                  1111    11                1              1  1
111111111111111111                                 11111 4                   1              1  1
1                                                  1111111111111111111       1              1  1
1      5                                        9                   111      1              1  1
1         5                                 111111111               1111     11             1  1
1                                     4                 111      4           111     U      1  1
111111111111111111111111111111111111111111111111 1111111111111111111111111111111  11111111111  1
111111111111111111111111111111111111111111111111 111111111111111111111111111111  111111111111  1
1                           3     11111111111111 111111111111                   11          1  1
1                            4                   111111111111              111111           1  1
1            11111       R 111111111111111111111 111111111111             11                1  1
1            1111          111111111111111111111 111111111111            11                 1  1
1                          111111111111111111111 111111111111           11                  1  1
1                          11111111        11111U111111111111          11                  11  1
1                          11111111        11111 111111111111         11                  111  1
1                          11111111  5                               11                  1111  1
1                          111111111111111111111 11111111           11                   3  1  1
1                       44 111111111111111111111 111111111         11                       1  1
1                       44 3 1111111111111111111 111111111111     4                         1  1
111         U           44   11111111     3         11111111111111111111111111111111111111111  1
11                      44   11111111               1111111111111                  3        1  1
13          111111111   44   11111111            1111111111111111                           1  1
1          111111111111111111111111111111111111111111111111111111      5         11111      1  1
1  2   4                                                                         111111     1 U1
111111111111111111111111111111111111111 1111111111111111111111111   5     9    111111111    1  1
111111111111111111111111111111111111111 11111111111111111111111  4            11111111111      1
111111111111111111111111111111111111111111111111111111111111111111111111111111111111111111111111
