11111111111111111111111111111111111
1        44                      D1
1        44                     5 1
111111111111111111111111111111    1
1 5   5 5555   555  5   5 5   5   1
1  5 5  5   5 5   5 55  5 5  5 5  1
1   5   5555  5   5 5 5 5 5  555  1
1  5 5  5     5   5 5  55 5 5   5 1
1 5   5 5      555  5   5 5 5   5 1
1                                 1
1 55555  555    5     5     5   5 1
1 5   5 5   5  5 5   5 5   5 5  5 1
1 5   5 5   5  5 5   5 5   555  5 1
1 5   5 5   5 5   5 5   5 5   5   1
1 5   5  555  5   5 5   5 5   5 5 1
1111                        2     1
1311                       111111 1
1  1R                L     11131111
1                                 1
11111111111111111111111111111111111
