11111111111111111111111111111111111
1            4     4           3  1
1 11111 111111111111111 1111      1
1                  D              1
1 5   5 5555   555  5   5 5   5   1
1  5 5  5   5 5   5 55  5 5  5 5  1
1   5   5555  5   5 5 5 5 5  555  1
1  5 5  5     5   5 5  55 5 5   5 1
1 5   5 5      555  5   5 5 5   5 1
1    4                            1
1    4                            1
1 55555  555    5     5     5   5 1
1 5   5 5   5  5 5   5 5   5 5  5 1
1 5   5 5   5  5 5   5 5   555  5 1
1 5   5 5   5 5   5 5   5 5   5   1
1 5   5  555  5   5 5   5 5   5 5 1
1 34  3  3                        1
1  4                              1
1111111U        2         44      1
11111111111111111111111111111111111
