111111111111111111111111111111111111111
13                                    1
1                                     1
1                                     1
1                                     1
1                                     1
1                                     1
1  111  11111  1111 1111  11111 11111 1
1 1   1 1     11  1 1   1 1       1   1
1 1     1     1     1   1 1       1   1
1  111  1111  1     1111  1111    1   1
1     1 1     1     1  11 1       1   1
1 1   1 1     11  1 1   1 1       1   1
1  111  11111  1111 1   1 11111   1   1
1                                     1
1                                     1
1          2                          1
111111111111111111111111111111111111111

