1111111+11111+11111+1111111111111111111
1  4                                  1
1  4                                  1
1=11                              81111
1=                                11311
1=                                    1
1=         4         p 4    p         1
1= 111  11111  1111 1111  11111 11111 1
1=1   1 1     11  1 1   1 1       1   1
1=1     1     1     1   1 1       1   1
1= 111  1111  1     1111  1111    1   1
1=    1 1     1     1  11 1       1   1
1=1   1 1     11  1 1   1 1       1   1
1= 111  11111  1111 1   1 11111   1   1
1=C                                   1
1=                            c       1
1=                                Σ  ρ1
1=c                  +  9  9  91  1^v11
1=         2    +                     1
111111111111111111111111111111+11111111

