1111111111111111111111111111111
1   1 <     1     >   3 1   1 1
1 1 1 1 111 1 111 111^1 1 1 1 1
1 1 1 1 13  1  31 Φ   1   1   1
1 111 1 11111 111 1 111111111 1
1 1   1 1     1   1 1      31 1
1 1v1 1 1 11111v111 1 1 11111 1
1   1 > 1     1   1   1   3   1
1 1 1 111Ω111 111 1 111111111 1
111 1       1   1 1           1 
1X1111111 11111 1 111111111^1 1
1     2         1   >     1   1
1111111v1 111111111 1 111 1 1Ω1
1   1   Φ         1 1   1   131
1 111 111111111 111 111 11111 1
1     1   13        1 1 13  1 1
1 11111 1 1111111 111 1 1 1 1 1
1       1 <  3    1       1   1
1111111111111111111111111111111