1111111111
1       31
1        1
1        1
1        1
1        1
1        1
1      ρ 1
1   2  | 1
1111111111