1111111111
1  4    31
1  B     1
1       Ψ1
1       91
1        1
1     __ 1
1   X    1
1 ψ  2 b 1
1111111111