$background: 15, 16, 1, 1, 25
11111111111111111111111111111111
11    1 3ι                    81
11   ψ1  ι                    J1
111=111  ι                     1
11 =1    ι                     1
11 =     ι                     1
11 =o                          1
11 =         4               9Ψ1
111=1111111111111 11111111111111
111=1           111            1
111=1G                        H1
111=13                        31
111=<                          1
111=111G       =     H1111111111
111=1111G      =    H11111111111
111=11111G     =   H111111111111
111=11311111111Â1111111111111111
11 =          c=               1
1  =     4  2  =   9 9 9 9 9 9 1
11111111111111111111111111111111