1111111111
1       31
1        1
1        1
1        1
1      O21
1     1111
1        1
1Φ   H   1
1111111111