11111111111111111111111111111111
1           1                 31
1           1                  1
1           1                  1
1           1                  1
1           l       pp         1
1=1111111111111111111111111    1
1=111111C        cC      c111111
1=1      11111111  1           1
1=1  5   11111118  1           1
1=111111 11111k11  1           1
1           1      1           1
11111111    11111  1Σ  ρ       1
1               1  11^v1       1
1               1  1 =         1
1               1  1 =         1
1°       .      1  1 =         1
1j              1  1 =         1
1             2 9  9          41
11111111+11111111++111111+111111