$hint: A yellow ball is not an elevator. Don't jump on a yellow ball that is going up, because then the ball will stop.
11111111111111++++++111111111111
11111111111111      111111111111
11111111111111&&&&&&111111111111
11111       ~~                Y1
1111T                    5     1
11311111111111      1111111=1111
1y                         =  11
1y                         =  c1
1y    4      1             =   1
111111111-1111        C    =  C1
11           ~      111111111111
1111                111C c111111
11311111111111                 1
11                             1
11                             1
11111111111111                 1
11     3     1                 1
11           19999            11
11    9 9      2       C      T1
11111111111111++++++111+11111111