$sticky: 23, 8, yes
$pistonmode: 23, 8, momentary
$group: 20, 3, 2
$group: 21, 3, 3
$group: 15, 16, 2
$sticky: 15, 16, yes
$pistonmode: 15, 16, momentary
$group: 20, 16, 3
$sticky: 20, 16, yes
$pistonmode: 20, 16, momentary
$inverted: 20, 16, yes
$group: 28, 16, 4
$group: 29, 0, 4
$sticky: 29, 0, yes
$pistonmode: 29, 0, momentary
$instrument: 26, 17, xylophone, 90
$notes: 26, 17, C4, E4, G4, C5
$stonepattern: 1
11111111111111111111111111111Ì11
1   ι 1 3  1   1       13    511
1   ι >        1       1      81
1111ι1111111        mm        11
1   ι    11111 11111111111111  1
1   ι     81C  1C  9     13 11^1
1   ι     11   8  1-1  9 >     1
1   ι     11   1      1111111111
1m 9      11          5Ö11111111
11111 111Ψ11    c   111111111111
11111^11111111111^111Φ     11111
1          1        11 111 1  φ1
1      4   l    5  ψ11 111 1  11
111 11111111=111111111 111 1  11
111   3     = 1 4444   111 1  11
111         = 1Φ111151Ω111)1  11
11k         = 1Ù1111Ù11111  m 11
1%   111    = 111111111111M 1 11
1    1111 2 = 11111111111Φ    11
11111111111111111111111111111Ω11