$pistonmode: 11, 15, toggle
$sticky: 11, 15, no
$group: 11, 15, 1
$pistonmode: 22, 15, momentary
$group: 22, 15, 2
$sticky: 22, 15, yes
$inverted: 22, 15, yes
$group: 16, 18, 2
$group: 25, 18, 2
$pistonmode: 30, 18, repeatfast
$group: 30, 18, 3
11111111111111111111111111111111
1 ι                           31
1 ι                            1
1 ι                    ppp     1
1 ι                   p        1
11ι11111111111111111111111111111
1 ι                            1
1 ι                            1
1 ι                            1
1 ι                            1
1 ι     111111111111    11111  1
1 ι       3   3  111     111   1
1 ι              111      3    1
1  2             111           1
11111   11111    111           1
11       31Ì11   11111Ì111111  1
1%        1ß11^1 11111ß1111311 1
1            >            >    1
111111111111m111m11111111m1111Ù1
11111111111111111111111111111111