11111111111111111111111111111111111
131                         D   131
111                             111
1               4                11
1   111111111111111111111111     31
1                                 1
1     55555  5   5  5555     5    1
1     5      55  5  5   5    5    1
1     555    5 5 5  5   5    5    1
1     5      5  55  5   5         1
1     55555  5   5  5555     5    1
1                                 1
1 111111111111111111111111111111  1
1                                 1
1                                 1
1                                 1
1U                                1
111                             111
131              2     4        131
11111111111111111111111111111111111