$gameticks: conveyorbelt, 12
$direction: 6, 12, left
$inverted: 3, 5, yes
$pistonmode: 3, 5, momentary
$sticky: 3, 5, yes
1111111111111111111111111111111
1                             1
1DE{ØØØØØØØØØØ}       4       1
1 1111111111!11    111111111111
1 111α             β11111111111
1 5Ö1               1         1
1  11       m2 44   1         1
1  1!     1111111 8α1         1
1  1       3      111         1
1  1                          1
1  +                    c     1
1  1                          1
1 41  {ØØØØØØØØØØ}           H1
1 E1  1111111111111111       31
1111    1  4         3        1
11      1  4            9   111
11      1 11{ØØØØØØ}        111
13       ^1111111111 1111111131
1                             1
1111111111111111111111111111111