$gameticks: conveyorbelt, 10
$direction: 17, 8, left
$stonepattern: 1
1111111111111111111111111111111111
1       141        141           1
1       141        141           1
1       141        141    5      1
1       141        141    5      1
1       1B1        1B1    Ø      1
1 5          }   {        Ø      1
1  5         Ø   Ø        Ø      1
1    5       Ø2  {    Ø Ø }      1
1       1=1111111111=1111111111111
1        =          =            1
1                                1
1        11111  11111            1
1           18  81  1            1
1           11  11  1            1
1                   1            1
1           11  11  1            1
1          118  81  1            1
1         1118  81  1111         1
1        11118  81    31         1
1b      111118  81     1         1
1111111111111111111111111111111111