$hint: Do not push a ball in the hole at the right of the stairs.
11111111111111111111111111111111
111111111                  3   1
1   3                          1
1                       111111 1
1     4                1111111 1
1  1111111111111111111         1
18                 11111111    1
11             4               1
11            111111111111111111
11       4 2 4                 1
11      1111111                1
11                             1
1                              1
1               1111111111111111
1     1 1111111 1111111111111311
1    11 1111111 1111111        1
1   111             4     111111
1  1111 1111111 11111 1111113111
1                              1
11111111111111111111111111111111
