$hint: Make a stack of 7 white balls between the 2 stacks. You can use also white balls of the 2 stacks.
11111111111111111111111111111111
1  31                          1
1   1        111111111111111   1
1 111          44       4      1
1            1111111 1111111   1
1U             44       4      1
1             1111 1    4 4    1
111     R 1  11118 1   11111   1
1           U 5  1 1           1
1             55               1
1             1111             1
1              55              1
1            11111             1
1                  4 4         1
1                  4 4         1
1                  4 4         1
1                  4 4         1
1                  4 4      U  1
1  2               4 4         1
11111111111111111111111111111111
