$direction: 16, 17, upright
$direction: 19, 17, upright
$direction: 14, 18, upright
$direction: 11, 19, upright
$direction: 25, 17, downright
11111111111111111111111111111111
1  141  131I        1 ι3      β1
1  1B1  1           1 ι        1
1       1      5    < ι   p p  1
1       1=11111111111 ι        1
1        =          1 ι        1
1        =          1 ι 1      1
1        =          1 ι 1      1
1b       =     55   < ι 1      1
1111 =111111  11111111ι 1      1
1  J1=1           1   ι 1      1
1   J=1           3   ι 1      1
1    =1                 1      1
1    =1      111 11111111      1
1    =18                      81
1    =11        1         9   11
1   Ξ=                        11
1G 11=          η  η  η  η    11
1T   =2 5     η          5    T1
11111111111η11111111111111111111