11111111111111111111
1                  1
1                  1
1                  1
1    .             1
1    3             1
1                  1
1    11111        p1
1                 p1
1         5       p1
1              11111
1               1111
1    11= 111  o 1111
1      =     o    11
1      =  11o    811
1G     =  1      811
1°     =  1      111
1      =  1        1
15     = 2         1
11111111111111111111