11111111111111111111111111111111
1             T = З    4       1
13            1 =111   4       1
1111111 111 1111=11111111      1
1                18  β1        1
13               11   1        1
11                    1        1
18                   α1        1
11                       p     1
111111111111111111111111 1111111
1T    4                        1
11            4       1        1
1             4       1        1
1         1111111111111        1
1     5              11        1
1     5              31        1
1                     1        1
1              1=111=11   5    1
1          2    = Є =       5  1
11111111111111111111111111111111