$gameticks: elevator, 20
$gameticksxy: 3, 4, 200
$inverted: 27, 11, yes
$sticky: 27, 11, yes
$pistonmode: 27, 11, momentary
11111111111111111111111111111111
1Ë4   84                 1     1
111   BB                 1     1
1                        1     1
1  )   G        11       1     1
1      1E L      1       1     1
1      11        1       1     1
1           .            1     1
1           3            1     1
1                        1     1
1  b                     <     1
111111111111111111111111111Ë 511
1      З     З     З     З J1= 1
1      1pp pp1     1pp pp1   = 1
1      1     1     1     1   = 1
1  p      p     p     p      = 1
1    4 1     1     1     1G  = 1
1pp ppp1     1pp pp1     1   = 1
1   2  Є     Є     Є     Є   = 1
111111111111111111111111111111m1
11111111111111111111111111111111