$stonepattern: 0
11111111111111111111
1 t                1
1 111111v11^111111t1
1 1            Ä 1 1
1 1Ä111111111111 1 1
1 1 1   1      1 1 1
1 1 1 1 1 1111 1 1 1
1 1 1 1 141  1 1 1 1
1 < 1 1 111  1 1 > 1
1 1 1 1      1 1 1 1
1 1 1 111 1  1 1 1 1
1 > 1   1 1111 1 < 1
1 1 111 1      1 1 1
1 1 1 1 1 111111 1 1
1 1 1   1   1 31 1 1
1 1 1111111 1  1Ä1 1
1 1 Ä            1 1
1t111111^11v111111 1
1        2       t 1
11111111111111111111