$group: 14, 15, 2
$inverted: 14, 15, yes
$pistonmode: 14, 15, momentary
$sticky: 14, 15, yes
$inverted: 9, 15, yes
$pistonmode: 9, 15, momentary
$sticky: 9, 15, yes
$group: 18, 8, 3
$inverted: 18, 8, yes
$sticky: 18, 8, yes
$group: 10, 18, 2
$group: 1, 4, 3
11111111111111111111111111111111
1   З                         81
1  1ì                         î1
1                              1
1m                             1
11111=111111  í1i  éeè      9  1
113  = 1   >  111              1
1τ   = Є 3 1  Є З 5     1      1
111111111111111111Ë 511111111111
11 C                  9      c11
11                      í1vi  11
18              íi       З 1  11
11        .     τ1      î11ì  11
11        3    111 5          81
1α              81 5         î11
1β       Ì1111Ì111             1
11   5   ß11%1ß111             1
11   5     < 2 > Є             1
1111111111m11111m111111111111111
11111111111111111111111111111111