$direction: 13, 5, left
$direction: 14, 5, left
$direction: 20, 18, left
$direction: 21, 18, left
$direction: 22, 18, left
$pistonmode: 11, 8, redball
$gameticks: mover, 5
11111111111111111111111111111111111
1111     3                       11
1111         5 9     2      111  31
1331 111111111111 111111111   11  1
1                   8       4  1111
1111  4      ηηE   Eηη      1   111
1111  4   11 111   111     11 11111
1111  4   11 111   11             1
1111U 4    Ë 8    U11        H    1
1111 111  111ηηEU  11       H1    1
111111111   11111  11     H 11    1
1111111111   3     11     1      81
11111111111     11 11            11
11111111111111111  11             1
1111111            11             1
1111111            11            11
1111111            11            31
1111111                           1
1111111            Eηηη1111 1111111
1111111           11111           1
11111111111111111111111111111111111