1111111111
1        1
1        1
1        1
1        1
1        1
1   Ц  Ч 1
13       1
1   2    1
1111111111