11111111111111111111
13      3          1
1          4       1
1L    111111111    1
1         1        1
1         1        1
1         1        1
1         1   55   1
1         1   55   1
1         1        1
1         1i       1
111111    11       1
1я1111    13       1
1         1        1
1         <        1
11111111111111111=11
11ì  3           = 1
1б               = 1
1        2       = 1
11111111111111111111