$extra: 1
$pistonmode: 3, 10, repeatslow
$sticky: 3, 10, yes
$stonepattern: 1
11111111111111111111
11                 1
11                 1
13       1         1
1        1         1
1  4   4 1         1
111111 111111      1
1        3         1
1  2               1
1 111           β111
1 5Ö11111111-111 111
1 111      3    β 81
1                B81
1        11111111111
1                 11
1                 11
1                 11
1                 я1
1b1                1
11111111111111111111