$extra: 1
$stonepattern: 1
11111111111111111111
1     1        3   1
1     3            1
1             111  1
1    FF         11^1
11   F1            1
1τ        p        1
1111111111p111111 11
1                 81
1                 11
1                 11
1                 11
1                 11
1              C  11
1   5       11111111
1   5       13    81
111111            11
1    Л     5      11
1 C      2        τ1
11111111111111111111