11111111111111111111
1     =           81
1 11p1=11         î1
1    1=11          1
1    1=11          1
1    1= T          1
11   1111          1
13                 1
1        p         1
111  111111 11     1
1   55      +1111111
1                 11
11                11
1+                +1
11                11
1                  1
1                  1
1           9      1
1T 2         +     1
11111111111111111111