$extra: 1
$stonepattern: 1
11111111111111111111
1=          1 3   11
1=1111111   <     T1
1=        1111111111
1=        11      11
1=        11      11
1=        18      81
1=        18      81
1=        11L     T1
11111             11
11111    11111    11
11                 1
11                 1
11                 1
11                 1
11                 1
1я                 1
1                  1
1           2   4  1
11111111111111111111