$pattern: 17, 3, 4, 4, 8, 8
$stonepattern: 1
11111111111111111111
11111111131131111111
11111            111
113 μ            Џ81
1τ    11111111 11111
11111113111111 11111
1 3        1Љ    131
1     5    1       1
1          <       1
1 1111Џ111Џ111111111
1   31     8C c    1
1          1       1
1   1              1
1 1111             1
1    11           ψ1
1            Ψ 1=111
1111           1=131
11 Љ       o  9 =  1
1τ      42      =  1
11111111111111111111