$inverted: 14, 10, yes
$sticky: 14, 10, yes
11111111111111111111
1      1      11α 81
1      1      1   11
1      1      18  β1
1      1      11   1
1    p 3     41    1
1B1 11       41    1
Φ Ѩ  1 1     41    1
Φ Ѩ  1 < 5   2     1
Φ Ѩ  1 11111111ЏЏЏ11
1 1111 1    11Ì   81
1    1     411ß   81
1    1     4      11
1    1111111111ЏЏЏ11
1    1111  1118   81
1   41111b 1111ѨѨѨ11
1   4   11=11 <   11
1   4     = 3 1   11
1Ω111111  =   1  m11
11111111111111111111