$gameticksxy: 10, 8, 3
$pistonmode: 4, 4, redball
$pistonmode: 17, 11, blueball
$group: 18, 1, 2
$group: 18, 18, 2
$group: 17, 9, 3
$group: 1, 1, 3
11111111111111111111
1τ  1        3 τ 1τ1
1   3      5     1 1
1 U      111111  1Ξ1
1   Ë   1181111  1 1
11 111 111S1111  1 1
1        1S1111  1 1
1        1B1111  1 1
1        1)1     1 1
1                τ 1
11 11111 1       1 1
1     3          Ö 1
1         H    H 111
1  B5     1    1 111
1  11     1    1 311
1         1    1  11
1         1111111111
11          3  3  11
1τ    2   b       τ1
11111111111111111111