$pistonmode: 3, 17, blueball
$pistonmode: 17, 4, whiteball
$stonepattern: 1
11111111111111111111
1   =      4111=   1
1   =      4111=   1
1   =      4 < =   1
1   =      1111= Ö 1
1   =      1111=1111
1   =          =   1
1   = 25       =   1
1111=1111  G   =   1
1   =          =   1
1   =    H 1 11=1111
1   =    1 1   =   1
1   =    1 1   =   1
1   =    1 1   =   1
1   =    1 1   = 111
1   =    1 1   = 131
1   =    111   =   1
1  Ë=          =   1
1111=  1111111111 11
11111111111111111111