$extra: 1
$stonepattern: 1
1111111111111111μ111
1                 31
1               μ111
1                  1
1           5      1
111111111 111111^111
1                111
1=1111111 1=11111131
1=       Δ =   μ   1
1=     4   =       1
1=    1111111 111111
111^1111111111111111
1                  1
1                  1
1        55        1
1^1^1111111111111111
1     u   Љ        1
1   2              1
111111111111111118 1
11111111111111111111