$gameticksxy: 15, 8, 250
$stonepattern: 1
11111111111111111111
1                D 1
1        Ѥ      1B11
111111Џ1111111111 11
1            3111 11
1             1Ë5 11
1=111111  1111111 11
1=            141  1
1=            1)1  1
1=            1 1  1
1=            1b1  1
1=            111  1
1=                 1
1=        5        1
1=111111111111111 11
1=  3    11        1
1=       ѥ3        1
1=       2         1
1111111111m111111111
11111111111111111111