$gameticks: pinkball, 10
$stonepattern: 1
11111111111111111111
1     31           1
1      1     Ѥ Ѥ2  1
1=111111     1111111
1=     1         τ11
1=     1 4       111
1= Ѥ   1111      131
1= BѤ              1
1=  BѤ             1
1=   B       1111111
1=                 1
1=                 1
111                1
111          1111111
111               11
111   1b1         11
111   1111        11
1                 11
1           5     τ1
11111111111111111111