$gameticks: pinkball, 15
11111111111111111111
1      ѤτѤ 1 =    11
1      B B 1b=    11
1          11=    11
1           2=  ψ τ1
1^11111   1111=11111
1   811Ѥ Ѥ1111=   31
1=  11 9 9 111=    1
1=  1       11=11111
1=  1       11=    1
1=  1       11=    1
1=  18     811=    1
1=  18     811=    1
1=1 18     811=    1
1=3 1111 11111=    1
1=       1    =    1
111 1111 1    =    1
131     9Ψ    =    1
1             = 5  1
11111111111111111111