$gameticks: pinkball, 7
$pistonmode: 12, 1, momentary
$stonepattern: 1
11111111111111111111
1C          Ö1     1
1                  1
1c   c             1
1                  1
1                  1
1                  1
1        9 D c     1
1      Ѥ2         m1
11111 11111Џ11111111
1         111     31
1                  1
1                 Џ1
1                111
18    G      1 ЏЏ 81
1ì      1111B1111111
1       1         31
1       5          1
1           11b11111
11111111111111111111