$pistonmode: 13, 16, lightblueball
$stonepattern: 1
11111111111111111111
1          T       1
1          ;       1
1                  1
1                  1
1                  1
1                  1
1                  1
1           H1111111
1          H13    31
1         H13      1
1         13  111111
1         3       11
1                 11
1                 11
1  255 5  55      11
11v1^11Џ     Ù    11
1              4  T1
11111111111111111111
11111111111111111111