$extra: 1
$gameticks: pinkball, 10
$gameticksxy: 7, 8, 6
$pistonmode: 17, 2, momentary
$stonepattern: 1
11111111111111111111
1               1111
1 Ѥ             =Ö11
111111Џ1111 1111=111
1      4       1=111
1 11  ѤѤ 42    1=111
1 18 111111    1=111
1 1Φ           1=111
1 11111)BBB    1=111
1 1          111=  1
1 1    b     3  = m1
1 1    1        =111
1 3            p=  1
1               =  1
1 111      111111111
1 111      111111111
1 111111         9 1
1 3                1
1                  1
11111111111111111111