$gameticks: ice, 350
11111111111111111111
1=  Ж              1
1=       4         1
1=1111111111111 1111
1=         11   1 31
1=         18   1  1
1=         1T      1
1=         111111111
1=                 1
1=                 1
1=       1111      1
1=       d 1k      1
1=         1       1
1=      11 1  5    1
1=42               1
1111WWWWWWWWWWWWW111
1111wwwwwwwwwwwww111
1111wwwwwwwwwwww1111
1111wwwwwwwwwwwwlwT1
11111111111111111111