$gameticks: ice, 500
11111111111111111111
1111  T1111111111111
1111  11111111111111
1111  4111114    Ж 1
11d   4     4      1
11   24     4    4 1
11 11111ЏЏЏ1111111Џ1
11   18     8118   1
11   11    11111  H1
11               H11
11G               31
111G       111     1
1111G       11     1
11111G      11111111
111111      T1111111
111111WWWWWW11111111
111111wwwwww11111111
111111wwwwww11111111
111111wwwwww11111111
11111111111111111111