$gameticks: phaseability, 100
$pistonmode: 4, 4, blueball
$stonepattern: 1
11111111111111111111
1    C   c   Ψ    11
1       1    9    τ1
1 4   5 τ       =111
1111Ë 111       =  1
1               =  1
1               = ψ1
1               =111
11111 111       =3Ѫ1
11111 111  4   2=  1
11118 11111111111111
1  J1 111111I J111I1
1      J11I        1
1        1         1
1i       1         1
13       1         1
1        1         1
1        1         1
1        1         1
11111111111111111111