$stonepattern: 1
11111111111111111111
13         =  3   =1
1          =      =1
1111ЏЏЏЏ111=111111=1
1111       =111111=1
1111       =      =1
1111       =      =1
11111     9=      =1
11113      =  4   =1
1111       =11111111
1111 5     =      31
111Ëo      =       1
11111c   Ѳ =      11
111111     =      11
111111     =      11
13        C=c     11
1          =       1
1    5     =       1
1        2 =      m1
11111111111111111111