$stonepattern: 1
$inverted: 18, 1, yes
$pistonmode: 18, 1, momentary
$sticky: 18, 1, yes
11111111111111111111
11                Ì1
11                51
11 E               φ
11 1E L            1
11 11   H G   111111
11  1  HI JG  1T 111
11  1 HI   JG 11 111
11  1 1  Δ  1 11 111
11  1V1  1  1V11  31
11  111  1  1111   1
11D      Φ       111
11       1111111 111
11        81   1 111
11        11   1 111
1T             1 111
11             1 131
11  4    2   m <   1
11 E1111111111111111
11111111111111111111