$stonepattern: 1
$pistonmode: 0, 15, momentary
$group: 18, 2, 2
$pistonmode: 18, 2, momentary
$pistonmode: 13, 10, momentary
$group: 3, 12, 2
$direction: 9, 7, up
11111111111111111111
1 44        3  = 411
1 44  1=1      = 4Ö1
1 111Џ1=1   111= 111
1 1   1=11  111= 111
1 1   1=13  111= 111
1 1   1=1   111= 111
1B1   1= њ 1111= 811
1 1   1=11 1111= 811
1 1   1=1  1111= 811
1 1   1=1  11Ì1= 111
1 1   1=1  11o1= 111
1 1m  1        = 111
1 11Џ1111111111=1111
1 11           = 111
Ë  3           = 111
1m             = 111
11V1           = 111
1111b 2        = 111
11111111111111111111