$extra: 1
$stonepattern: 1
$pistonmode: 8, 16, momentary
$group: 18, 1, 3
$pistonmode: 18, 1, momentary
$group: 1, 12, 2
$group: 6, 17, 3
$direction: 10, 14, up
$direction: 11, 14, up
$direction: 12, 14, up
$direction: 13, 14, up
$group: 3, 4, 2
111111111111111111111
1                1Ì11
1                1o31
1=11111111111111    1
1=1њ444444    τ1111Џ1
1=11111111    î1111 1
1                 1 1
11111111          1 1
11111111   5      1 1
11111111       55 1 1
1  11111      11111 1
1      11     11111 1
1m  2  τ1      44 1 1
111111111     111 1 1
Φ      11 њњњњ111 1 1
1 ѨѨѨѨѨ11     111 1 1
1      1Ë   11111 1 1
1     m11m  13111   1
1 11111111 11  11 111
1          φ1     φ11
1Ω1111111111111111111