$extra: 1
$stonepattern: 1
111111111111111
1T       +   11
11   24      11
1  111111Џ   11
1 Ó13  =     11
1 ö1  1=     81
1 ö1111=     81
1 Ò    =     11
1      =     11
1      =     11
1      =     11
1      =   . 11
11   5 =     11
11     =  +  T1
111111111111111