$gameticks: timebomb, 300
$stonepattern: 2
$group: 13, 3, 2
$pistonmode: 13, 3, momentary
$group: 1, 18, 2
11111111111111111111
1              c1111
1            +    11
1b Ξ         Ù    11
11111=111    1    31
1    =         9   1
1  њ =             1
11111=111    1111111
1    = 11VVVV1111111
1    = 11VVVV1111111
1    = 31VVVV1111111
1m   =  1VVVV1111111
11111=  111111111111
1    =       1111111
1LB  =       1111111
1    =      B1111111
1    =     1D1111111
1    =     111111111
1m   =   2 111111111
11111111111111111111