$gameticks: brownball, 1
$extra: 1
$stonepattern: 2
$pistonmode: 15, 18, momentary
111111111111111111111
1              1   11
1     111   b  1   11
1   1113111111^1   11
1                  11
1         5        11
1           Ь      11
111 1111^111111    11
1                  11
1       1     1    31
1      m11   11m    1
1  11111111^11111 111
1                   1
111111111-11B11     1
111131118 11 111    1
1     111 11   11   1
18      Ь  Ь  Ь  2  1
111111111111111114111
111111111111111ËΩ4 11
111111111111111111111