$extra: 1
$stonepattern: 2
1111111111111111111
1      њѤѤѤЬ      1
111111111111 111111
111111111        T1
111111111        11
111111111        11
111111111  11111Џ11
111111111        11
11     1         11
11 1  11        m11
11 11 Ь         111
11 111111        11
11      1        11
11      1        11
13      1        11
1       1     2  T1
1111111111111111111