$extra: 1
$hint: Push the yellow ball up.
$stonepattern: 1
111111111111111
1   =   3     1
1   =         1
1   =     5 9 1
1111=1111111111
1   =        81
1   =      1111
1   =      1111
1   =      1111
1   =        31
1   =         1
1   =       111
1   =   9   111
1   = 4  2  111
111111111111111