$extra: 1
$stonepattern: 1
$answer: 6, 4, 266
$answer: 6, 5, 216
$answer: 6, 6, 215
$answer: 6, 7, 225
$question: 12, 8, 15²
$answer: 12, 8, 225
$question: 9, 11, 6x36
$answer: 9, 11, 216
$question: 11, 11, 5x45
$answer: 11, 11, 225
$question: 13, 11, 7x38
$answer: 13, 11, 266
111111111111111111
1      =         1
1     4=         1
1     1=1        1
1     ҹ=         1
1     ҹ=    111111
1     ҹ=    111 31
1     ҹ=    1    1
1    11=    Ҹ    1
1      =1111111111
1      =1111111131
1      = Ҹ Ҹ Ҹ   1
1      =1 1 1 1111
1      =         1
1      =    2    1
111111111111111111