$extra: 1
$stonepattern: 2
$answer: 11, 11, 1
$answer: 17, 14, 0.5
$pistonmode: 7, 15, momentary
$question: 12, 14, {center}sin
$answer: 12, 14, 1
$question: 13, 14, {center}(90°)
$answer: 13, 14, 1
$question: 12, 17, {center}sin
$answer: 12, 17, 0.5
$question: 13, 17, {center}(60°)
$answer: 13, 17, 0.5
11111111111111111111
1++ =1k        =1 T1
1   =1         =1 11
1   => Π       =1 31
1&& =1111111111=1  1
1   =1C      c1=11 1
1   =1 111111 1=   1
1   =1 13111   =   1
1   =1c  9   11=   1
1   =11^v111111=   1
1   =11       1=   1
1  1=1111  ҹ Π1=   1
1  1=1111111111=   1
T991=l    3 111=   1
1  1=1111   ҸҸ = ҹ 1
1^v1111Ì111m111=1111
1   31151111111=   1
111         ҸҸ = 2 1
111111111111111=1111
11111111111111111111