$extra: 1
$stonepattern: 1
$answer: 6, 10, 23
$answer: 7, 10, +
$answer: 5, 2, 12
$answer: 10, 2, =
$answer: 6, 13, 29
$answer: 10, 13, -
$answer: 12, 2, 64
$answer: 14, 2, 19
$answer: 12, 13, 13
11111111111111111111
1                  1
1    ҹ    ҹ ҹ ҹ    1
11=11111111111111=11
11=11           1=11
11=11           1=11
11=13           1=11
11=1            1=11
11=1      Π     1=11
1 =1111^111111111= 1
1 =   ҹҹ         = 1
11=11111111111111=11
11=1            1=11
11=   ҹ   ҹ ҹ    =11
11=11111111111111=11
11=1            1=11
11=1            1=11
11=1            1=11
11=      2       =Π1
11111111111111111111