11111111111111111111111111111111
1                  C       c   1
1                              1
1                              1
1                              1
1                          9   1
1                              1
1              4     42      5 1
111111 1111=1111111 111111111111
1k        1=1               1 31
1       5 l=1               l  1
1111 11111111             1=1111
1                          =   1
1                          =   1
1                          =   1
1                          =   1
1   U                      =   1
1                          =   1
1       S    S       S     =   1
11111111111111111111111111111111