11111111111111111111111111111111
11                  1   3     11
11              4   l         τ1
11           1111111111111111111
11       4                     1
11       4    p                1
11 111111111111111             1
11     111       k             1
11U1    3        1             1
11 1                           1
11 11111111111111              1
11    τ        1α             81
11 1111                       11
1                             11
11                            31
11                             1
11          5                  1
11             2 4             1
11111111111111111111   111111111
11111111111111111111111111111111