11111111111111111111111111111111
11 <             1111111      11
11=1=11111111111^1111111   b  11
11=1=111k  B     111111111111=11
11=1=111   1=111111 τ l      =11
11=1=111^111=11111111111^1111=11
11=1=1τ  111               11=11
11=1=111111111111111111111=11=11
11=1                     1=11=11
11 111111111111111111111 1=11=11
11^111     1111111   113 1=11=11
1       9     >   44     1=11=11
19=1111111111-111111111111=11=11
1 =11         111111111111=11=11
11=11 1111111111      1111=11=11
11=11    4        111  55    o 1
11=11111111111B11113111111 111=1
11=11111111               p111=1
11 <  2     11    1111111      1
11111111111111111111111111111111