11111111111111111111111111111111
13                             1
1                              1
1                              1
1                              1
1                              1
1                              1
1               E111E          1
1                              1
1                              1
1                              1
1                              1
1                1             1
1                1  s          1
1111E    R      E111E          1
1                              1
1                    U         1
1       5                      1
1      25                      1
11111111111111111111111111111111