1111111111
1       31
1   9   φ1
1  9Ψ9   1
1   9    1
1        1
1        1
1        1
1 Ψ Ω  2ψ1
1111111111