11111111111111111111111111111111
11      1 55 4    3            1
1T   11 3 11111                1
1111111   1   1=1111           1
1     11111    =           1   1
1              =           14  1
1=1111111111111=1111111111114111
1=             Ψ            4  1
1=1111111111C     c1áäääääà11111
1=1          1   1            11
1=1          1   1            11
1=1          11111            11
1=1          1T  1            11
1=1          11^11          4 11
1=                          4 11
1=1111111111c 9 9 C1       v1^11
1=111       11 Ψ 11            1
1=111       1     1        11111
1=131       111=111            1
1=<            =               1
1=1         5  =               1
1              =        2     ψ1
1111111   1111111111111111111111
11111111111111111111111111111111