11111111111111111111111111111111
1                C           9Ψ1
1   E      EG     Ψ            1
1   1G            9           H1
1    4G           B           k1
1    B                         1
1 4    Δ  U                    1
11E   H1G         c           c1
1                              1
1        E                     1
1     Ψ   1            C      C1
1                              1
1                              1
1  U         b                 1
1111  11111111111 1            1
ΦB     11113    X 1            1
111  ψ11111       1          111
13111111111       11v11 11111131
1           4 2           l    1
11111111111111111111111111111111