1111111111
1       31
1        1
1        1
1        1
1        1
1 3   3  1
1113j  311
111  2 111
1111111111