1111111111
1        1
1  4424  1
1  11111 1
1      4 1
1111   111
13     3 1
1111     1
1111 1   1
1111111111