1111111111
18β     φ1
11  111  1
11   31  1
11    1  1
1  1111  1
1 Φ      1
1    p   1
1  Ω25   1
1111111111
